AF=Afeganistão
ZA=África do Sul
AL=Albânia
DE=Alemanha
AD=Andorra
AO=Angola
AI=Anguila
AG=Antígua e Barbados
SA=Arábia Saudita
DZ=Argélia
AR=Argentina
AM=Armênia
AW=Aruba
AU=Austrália
AT=Áustria
AZ=Azerbaijão
BS=Bahamas
BH=Bahrein
BD=Bangladesh
BB=Barbados
BY=Belarus
BE=Bélgica
BZ=Belize
BJ=Benin
BM=Bermuda
BO=Bolívia
BA=Bósnia-Herzegóvina
BO=Botsuana
BR=Brasil
BN=Brunei
BG=Bulgária
BF=Burkina Fasso
MM=Burma (Myanmar)
BI=Burundi
BT=Butão
CV=Cabo Verde
CM=Camarões
KH=Camboja
CA=Canadá
KZ=Cazaquistão
TD=Chade
CL=Chile
CN=China
CY=Chipre
CG=Cingapura
CO=Colômbia
KP=Coréia do Norte
KR=Coréia do Sul
CI=Costa do Marfim
CR=Costa Rica
HR=Croácia
CU=Cuba
DK=Dinamarca
DJ=Djibuti
DM=Dominica
EG=Egito
SV=El Salvador
AE=Emirados Árabes Unidos
EC=Equador
ER=Eritréia
SK=Eslováquia
SI=Eslovênia
ES=Espanha
US=Estados Unidos da América
EE=Estônia
ET=Etiópia
FJ=Fiji
PH=Filipinas
FI=Finlândia
FR=França
GA=Gabão
GM=Gâmbia
GH=Gana
GS=Geórgia do Sul
GE=Geórgia
GI=Gibraltar
GD=Granada
GR=Grécia
GL=Groenlândia
GU=Guam
GT=Guatemala
G=Guernsey
GY=Guiana
GW=Guiné-Bissau
GQ=Guiné Equatorial
GN=Guiné
HT=Haiti
NL=Holanda
HN=Honduras
HK=Hong Kong
HU=Hungria
YE=Iêmen
NF=Ilha Norfolk
PN=Ilha Pitcairn
KY=Ilhas Cayman
KM=Ilhas Comores
CK=Ilhas Cook
FK=Ilhas Falkland
FO=Ilhas Faroe
MP=Ilhas Marianas do Norte
MH=Ilhas Marshall
SB=Ilhas Salomão
SC=Ilhas Seychelles
TC=Ilhas Turks e Caicos
VI=Ilhas Virgens Americanas
VG=Ilhas Virgens Britânicas
IN=Índia
ID=Indonésia
IR=Irã
IQ=Iraque
IE=Irlanda
IS=Islândia
IL=Israel
IT=Itália
JM=Jamaica
JP=Japão
JE=Jersey
JO=Jordânia
KI=Kiribati
KW=Kuait
LA=Laos
LS=Lesoto
LV=Letônia
LB=Líbano
LR=Libéria
LY=Libia
LI=Liechtenstein
LT=Lituânia
LU=Luxemburgo
MO=Macau
MK=Macedônia
MG=Madagascar
MY=Malásia
MW=Malavi
MV=Maldivas
ML=Mali
MT=Malta
MA=Marrocos
MQ=Martinica
MU=Maurício
MR=Mauritânia
MX=México
FM=Micronésia
MZ=Moçambique
MD=Moldávia
MC=Mônaco
MN=Mongólia
ME=Montenegro
MS=Montserrat
NA=Namíbia
NR=Nauru
NP=Nepal
NI=Nicarágua
NE=Níger
NG=Nigéria
NU=Niue
NO=Noruega
NZ=Nova Zelândia
OM=Omã
PW=Palau
PA=Panamá
PG=Papua-Nova Guiné
PK=Paquistão
PY=Paraguai
PE=Peru
PF=Polinésia Francesa
PL=Polônia
PR=Porto Rico
PT=Portugal
QA=Qatar
KE=Quênia
KG=Quirguistão
UK=Reino Unido
CF=República Centro-Africana
CZ= República Checa
CD=República Democrática do Congo
CG=República do Congo
DO=República Dominicana
RO=Romênia
RW=Ruanda
RU=Russia
AS=Samoa Americana
WS=Samoa
SM=San Marino
SH=Santa Helena
LC=Santa Lúcia
KN=São Cristóvão e Névis
PM=São Pedro e Miquelão
ST=São Tomé e Príncipe
VC=São Vicente e Granadinas
SN=Senegal
SL=Serra Leoa
RS=Sérvia
SY=Siria
SO=Somália
LK=Sri Lanka
SZ=Suazilândia
SD=Sudão
SE=Suécia
CH=Suiça
SR=Suriname
TJ=Tadjiquistão
TH=Tailândia
TW=Taiwan
TZ=Tanzânia
IO=Território Britânico do Oceano Índico
TL=Timor-Leste
TG=Togo
TO=Tonga
TT=Trinidad e Tobago
TN=Tunísia
TM=Turcomenistão
TR=Turquia
TV=Tuvalu
UA=Ucrânia
UG=Uganda
UY=Uruguai
UZ=Uzbequistão
VU=Vanuatu
VA=Vaticano
VE=Venezuela
VN=Vietnã
ZM=Zâmbia
ZW=Zimbábue